migpuma1,migpuma_name,net migration,migplac1,median_real_wage,n_out,n_in
4600,Houston City,5603,48,25338.857142857145,107138,112741
100,Maricopa County,4648,4,28033.45081967213,95644,100292
2500,Tarrant County,4648,48,29830.08510638296,46211,50859
400,Clark County,4577,32,28063,69415,73992
190,Denver City,4394,8,32123.976470588233,72326,76720
2000,Denton County,3839,48,36382.20000000009,14858,18697
5900,San Antonio City,3647,48,25872.96202531654,40964,44611
1100,Broward County,3454,12,23201.822916666646,41060,44514
3100,Charlotte City,3415,37,23021.516129032254,21117,24532
6700,Sacramento County,2984,6,24588.373626373632,33660,36644
4100,El Paso County,2622,8,28078.55670103092,19406,22028
9500,Orange County,2587,12,23630.870370370438,28883,31470
10300,Pinellas County,2398,12,24599.749999999956,20356,22754
4100,Columbus,2388,39,26207.71014492757,28018,30406
6500,Riverside County,2357,6,28971.75342465753,39862,42219
9900,Palm Beach County,2324,12,24038.50000000001,26506,28830
5200,Capital Area COG,2249,48,33240.15789473694,8801,11050
3000,Atlanta Regional Commission,2227,13,25753.454545454566,15953,18180
11500,Pierce County,2084,53,31039.799999999996,19487,21571
3100,Duval County,2039,12,21953.026548672548,23488,25527
10500,Spokane County,1972,53,28712.121212121223,9021,10993
1300,Contra Costa County,1890,6,38516.83783783787,14606,16496
5700,Hillsborough County,1832,12,25714.45544554406,31956,33788
8100,Manatee County,1821,12,28718.29032258063,6107,7928
11700,Snohomish County,1648,53,38571.39999999987,16098,17746
490,Ada County,1643,16,26296.05309734513,14004,15647
1100,Prince George's County,1627,24,33656.9090909091,18377,20004
1290,Tulsa County,1614,40,27001.92857142857,22878,24492
3100,Montgomery County,1550,42,30783,7357,8907
290,Outer Manchester City,1549,33,35753.5,17610,19159
7100,Lee County,1537,12,25077.13513513513,11347,12884
390,Middlesex County,1518,25,32636.399999999972,57958,59476
7100,San Bernardino County,1476,6,28519.909090909092,37192,38668
5000,Atlanta Regional Commission,1470,13,20311.125,8274,9744
9500,Solano County,1463,6,40188.72340425531,8670,10133
5300,Austin City,1450,48,27373.464285714283,24688,26138
1490,Des Moines City,1436,19,32618.699999999997,14346,15782
1000,Oklahoma County,1402,40,25217.261904761905,21129,22531
900,Kansas City,1335,29,35150.46464646464,6361,7696
790,Albuquerque City,1303,35,20402.468750000025,14516,15819
1100,Horry County,1207,45,26007.514285714282,6615,7822
1200,Wake County,1203,37,30452.6,19026,20229
2900,Kern County,1178,6,28037.333333333336,18728,19906
1000,Kent County,1115,26,22340.999999999975,12303,13418
100,Washoe County,1113,32,26480.44262295082,11497,12610
4700,Galveston County,1100,48,28000.58620689657,7044,8144
11400,Thurston County,1067,53,35358.947368421046,5285,6352
400,Coastal Regional Commission,1060,13,26937.52941176471,6265,7325
7700,San Joaquin County,1046,6,30520.021739130436,13212,14258
9900,Stanislaus County,1042,6,26260.66666666666,10355,11397
500,Cass County,1034,38,34486.81395348835,3797,4831
800,Texoma COG,995,48,30639.05844155844,4481,5476
3590,Volusia County,993,12,23035.76470588235,8941,9934
51175,Newport News City,988,51,24542.846153846156,5084,6072
1300,Durham County,975,37,25904.222222222226,6551,7526
4800,Houston-Galveston Area Council,972,48,44256.229357798155,4841,5813
500,South Plains Association of Governments,962,48,21371.55555555555,7742,8704
1200,Charleston,905,45,28348.223880597012,15467,16372
1327,Washington County,905,41,31890.964285714297,11032,11937
1500,Charlotte County,896,12,21341.571428571428,2669,3565
290,Toledo City,888,39,23717.983193277316,15129,16017
1900,Clay County,886,12,27896.499999999996,4238,5124
1900,Rensselaer County,882,36,41116.07692307689,2760,3642
300,Panhandle Regional Planning Commission,880,48,46146.230769230766,2614,3494
2000,Westmoreland County,875,42,28606.840000000004,4114,4989
700,North Texas Regional Planning Commission,864,48,21773.600000000002,2884,3748
2300,Dallas County,858,48,23990.169811320753,61977,62835
1090,Hawkins & Sullivan,857,47,19661.79661016949,3587,4444
4600,Montgomery County,856,39,20674.26865671642,13696,14552
2200,NA,834,47,25632.553571428576,2334,3168
2500,Nashville-Davidson,827,47,22114.685714285715,15871,16698
6900,Lake,820,12,20764.984615384616,6337,7157
3100,Westchester County,813,36,32934.210526315794,10407,11220
1900,Bluegrass Area Development District,803,21,26232.897959183672,7655,8458
57000,Weber County,801,49,28436.156249999985,4534,5335
2400,Johnson County,799,18,31177.424657534248,2589,3388
6100,Indian River County,795,12,27121.86956521738,2113,2908
100,Benton County,791,5,31479.65217391305,4112,4903
600,Johnson County,791,20,31760.263157894715,10363,11154
201,Central Rhode Island,777,44,35956.968,2573,3350
100,West North Dakota,763,38,42893.8983050847,5600,6363
100,New Castle County,758,10,25637.607594936708,8842,9600
8300,Marion County,754,12,21758.499999999996,5307,6061
3500,Davidson County,753,37,24787.076923076922,3132,3885
2400,Rutherford County,743,47,32111.255813953485,5952,6695
2500,Northern Kentucky Area Development District,736,21,22411.27419354837,2535,3271
2000,South Region,735,28,22592.591836734693,6160,6895
2700,Washtenaw County,735,26,23386.407407407412,4770,5505
4300,Atlanta & Northeast Georgia Regional Commissions,734,13,25161.55319148936,3148,3882
8500,Martin County,731,12,18831.02564102564,2312,3043
701,"Dodge, Cass, Saunders & Washington Counties",728,31,29287.304,1828,2556
1700,Allegheny County,726,42,25905.963636363642,18809,19535
6000,Atlanta Regional Commission,718,13,32398.780269058298,3946,4664
104,Dane County,715,55,29268.208333333332,9320,10035
1500,East Texas COG,715,48,25329.296296296296,4293,5008
3100,"Tipton, Fayette & Lauderdale Counties",714,47,21465.307692307695,1879,2593
4100,Chesterfield County,709,51,34373.086956521736,5275,5984
6600,Coastal Bend COG,697,48,28591.4545454545,10529,11226
500,York County,691,45,26605.75471698113,3509,4200
51120,George Washington Regional Commission,690,51,36739.4358974359,3196,3886
11500,Sarasota County,683,12,25755.866666666665,6040,6723
100,Northwest Wisconsin,673,55,25360.254901960783,2648,3321
101,Pickens & Oconee Counties,663,45,25233.499999999993,2888,3551
500,Baltimore County,660,24,37149.56000000002,11766,12426
400,NA,659,31,23621.767441860466,2199,2858
1601,NA,655,55,24162.741935483868,2797,3452
400,St. Joseph County,654,18,20065.89830508475,4434,5088
300,"Riley, Geary & Pottawatomie Counties",649,20,27007.6779661017,3007,3656
51110,Central Shenandoah Planning District Commission,646,51,28964.275862068964,1804,2450
2300,Cumberland County,633,42,32961.11627906974,4040,4673
51100,Virginia Beach City,626,51,34140.21052631579,11714,12340
50000,NA,626,55,21690.47272727273,1538,2164
600,"Stephens, Caddo, Comanche",625,40,26681.000000000004,5941,6566
2600,NA,624,42,29067.4375,1979,2603
6500,Coastal Bend COG,621,48,32609.28571428571,2418,3039
190,"Lauderdale, Colbert, Franklin & Marion",617,1,19673.766666666645,5510,6127
2500,Northwest Georgia Regional Commission,612,13,30989.857142857112,2945,3557
10100,Sutter & Yuba Counties,611,6,31084.545454545463,4075,4686
4200,Pitt County,606,37,19330.6,4185,4791
11300,Santa Rosa County,604,12,40741.36111111112,3072,3676
2400,"Mower, Steele, Freeborn & Dodge Counties",603,27,29149.076923076933,1917,2520
10790,St. Johns County,601,12,30914,4437,5038
3001,Tooele & Box Elder Counties,601,49,38463.02325581395,1921,2522
2100,Camden County,592,34,23964.921875,6952,7544
300,Bergen County,579,34,31087.08910891089,7370,7949
10800,NA,577,53,37627.65178571428,2591,3168
500,Yavapai County,571,4,24058.999999999993,4047,4618
2000,Jefferson County,570,29,35624.95555555557,4313,4883
2100,South Central Planning & Development Commission 3,569,22,31613.850000000002,2079,2648
690,East Montana,564,30,22937.249999999993,5620,6184
51255,Alexandria City,561,51,38360.867469879515,2612,3173
1100,Faulkner & Lonoke Counties,560,5,25557.797752809,3712,4272
1800,Union County,559,34,21891.03999999996,7145,7704
1000,Allen County,555,18,24732.975000000017,7903,8458
606,Lexington,555,45,27193.103448275862,5551,6106
200,Coordinating & Development Corporation 3,552,22,30315.950000000004,2735,3287
300,South Central North Dakota,546,38,58346.56989247312,2157,2703
3000,Gaston County,543,37,27770.24999999998,3995,4538
1500,Sevier & Jefferson Counties,542,47,18528.854166666682,2910,3452
3800,NA,541,37,28243.363636363636,2400,2941
3400,Central Texas COG,539,48,20003.421052631576,3670,4209
51135,Crater Planning District Commission,531,51,28656.358974358973,3724,4255
11100,Clark County,530,53,30469.153846153815,10435,10965
800,"Johnson, Lafayette, Ray, Clinton & Caldwell Counties",529,29,24672.714285714275,2593,3122
51235,Richmond City,529,51,24296.989795918365,5544,6073
400,"Berkeley, Jefferson, Mineral, Hampshire & Morgan Counties",528,54,35382.535211267605,2860,3388
3100,St. Clair County,527,26,26774.829787234034,3731,4258
2700,"Taney, Barry, Stone & McDonald Counties",526,29,19527.791208791212,3052,3578
1500,NA,526,29,32080.44999999998,1718,2244
500,Jefferson & Lewis Counties,525,36,23274.705882352937,3459,3984
1600,"Garland, Hot Spring, Clark & Montgomery Counties",521,5,17673.08597285068,3538,4059
200,Outer Green Bay City,512,55,32023.738461538473,5746,6258
2090,Montgomery City & Pike Road Town,510,1,21944.84971098266,9206,9716
3700,Northeast Georgia Regional Commission,501,13,29939.111111111113,880,1381
700,Yuma County,501,4,24235.89999999999,5026,5527
1300,Sedgwick,500,20,25384.507692307696,12717,13217
1200,Madison County,491,17,33035.42105263158,4807,5298
1900,Fresno County,489,6,22526.63157894736,20927,21416
1100,Marion County,485,41,24958.689655172413,6871,7356
1300,Central Region,483,28,33492.931818181816,3230,3713
1600,Capital Region Planning Commission 5,480,22,25842.962962962967,1632,2112
700,Lane County,480,41,27423.12499999999,7858,8338
1700,River Valley Regional Commission,479,13,21721.102040816328,7003,7482
2000,Bluegrass Area Development District,477,21,28175.316582914573,2205,2682
53001,Washington County,477,49,27229.47058823529,3275,3752
2900,Concho Valley COG,475,48,28101.134453781513,2246,2721
500,Barren River Area Development District,474,21,24945.781512605045,2575,3049
3300,Escambia County,471,12,22886.92727272728,5723,6194
290,Limestone & Madison,471,1,22746.00000000001,10801,11272
1400,NA,471,29,22101.969696969696,2542,3013
1600,Alamance County,468,37,23318.499999999993,3347,3815
800,Lancaster County,466,31,27277.714285714283,6041,6507
100,North Delta Region,465,28,39175.6992481203,3140,3605
10100,Whatcom County,463,53,32038.00000000001,3778,4241
1400,Sebastian & Crawford Counties,461,5,17934.492307692308,4434,4895
1100,Anoka County,460,27,35818.43037974683,6356,6816
2100,NA,458,29,35621.12903225806,2229,2687
1000,Kanawha & Clay Counties,454,54,17855.66666666665,3791,4245
1800,Capital Region Planning Commission 7,453,22,27674.062992125986,3078,3531
1326,Clackamas County,453,41,34071.2,7136,7589
1800,Ingham County,453,26,23204.1935483871,5883,6336
1400,NA,452,40,39144.92307692306,3284,3736
5400,Capital Area COG,449,48,40004.49438202249,2769,3218
51200,Henrico County,448,51,27567.728395061727,6228,6676
1800,Winston-Salem City,448,37,22453.615384615383,7380,7828
300,NA,447,6,23933.000000000004,2784,3231
100,Panhandle Regional Planning Commission,445,48,30852.15909090909,3861,4306
590,"Franklin, Vance & Warren",444,37,20203.909090909092,3093,3537
2390,Regional Planning Commission 4,438,22,22820.597560975602,9691,10129
2390,"Haywood, Madison, Swain, Graham & Jackson",435,37,18818.77272727266,3007,3442
3000,Permian Basin Regional Planning Commission,435,48,45978.56060606061,3884,4319
11700,Seminole County,435,12,26223.291666666646,6960,7395
700,Kisatchie Delta Regional Planning & Development District 2,432,22,25296.901408450707,3028,3460
2700,Berks County,429,42,28641.375,7014,7443
100,Greenville County,427,45,26305,9848,10275
2500,Sheboygan County,426,55,30601.083333333332,1920,2346
4400,Miami County,425,39,25995.19999999999,2873,3298
700,Onondaga County,425,36,25187.142857141862,7787,8212
3900,NA,421,37,18743.31343283582,2114,2535
2100,"Morgan, Putnam & Brown Counties",420,18,29219.08641975308,2486,2906
3800,Licking County,418,39,23922.411764705877,3316,3734
2300,Kankakee County,417,17,41387.61538461538,1736,2153
300,NA,417,46,24547.44827586208,2493,2910
1200,Anne Arundel County,415,24,44285.4328358209,8494,8909
11600,King County,413,53,35601.67999999999,39865,40278
1200,Tippecanoe County,412,18,32498.307692307688,3740,4152
1200,Ocean County,410,34,30775.999999999996,6944,7354
800,NA,410,27,30858.547169811318,1800,2210
900,"Campbell, Claiborne, Scott, Morgan & Hancock Counties",407,47,18930.629629629628,1233,1640
1000,Sauk & Columbia Counties,407,55,26440.88888888889,2197,2604
500,Southern Georgia Regional Commission,407,13,20949.59999999998,2031,2438
51115,George Washington Regional Commission,404,51,39734.87804878049,3056,3460
2200,"Blue Earth, Nicollet & Waseca Counties",403,27,27571.62068965518,1755,2158
1900,Collin County,401,48,39296.04651162789,13249,13650
5200,"Hoke, Richmond & Scotland Counties",400,37,15715.315789473681,2333,2733
5800,Alamo Area COG,399,48,41152.857142857145,1681,2080
3100,Permian Basin Regional Planning Commission,399,48,36859.3125,3819,4218
1900,Eaton & Clinton Counties,398,26,29681.86956521739,2969,3367
300,LaPorte County,397,18,15803.63694267516,2084,2481
3900,NA,397,48,28893,2444,2841
100,West South Dakota,392,46,27695.698113207553,4569,4961
3000,Macomb County,391,26,31403.988095238095,16173,16564
3000,Kane County,389,17,29118.25,8068,8457
600,Boone County,388,29,22579.956521739125,2703,3091
300,Sussex County,386,10,27861.5,2526,2912
200,Washington County,385,5,22474.827586206862,4414,4799
600,Linn & Benton Counties,384,41,30176.384615384613,3563,3947
800,NA,382,47,21640.878048780487,1644,2026
8300,Santa Barbara County,380,6,31240,6777,7157
800,"Cabell, Wayne & Mason Counties",379,54,19992.661417322837,2320,2699
600,Southeast Nebraska,379,31,26117.50000000004,2443,2822
11100,St. Lucie County,378,12,21030,5641,6019
10500,Polk County,377,12,25926.52941176473,11877,12254
2600,Greene County,376,29,24634.545454545463,9614,9990
1900,Lee County,374,1,22568.12068965517,2239,2613
5390,Union,373,37,31115.325581395333,3688,4061
1100,Pottawatomie,372,40,26358.999999999985,3790,4162
800,Shawnee,369,20,27371.707317073175,4206,4575
9700,Sonoma County,368,6,32293.212765957447,8062,8430
1600,Knox County,366,47,27374.2,9451,9817
3601,Brazos Valley COG,365,48,28904.538461538454,1866,2231
1300,NA,365,26,22275.14285714285,1434,1799
700,Muskegon County,364,26,30629.329268292735,3878,4242
1300,Arlington County,362,51,53895.22651933702,1951,2313
3500,Central Texas COG,362,48,26563.85714285714,10649,11011
4007,Atlanta Regional Commission,358,13,27181.515789473684,14807,15165
10000,Kenosha County,357,55,25827.381818181813,3206,3563
900,La Crosse County,357,55,33224.71782178218,2157,2514
1000,NA,354,41,20817.076923076922,2078,2432
3600,Northeast Georgia Regional Commission,353,13,16805.18390804597,2133,2486
10700,Loudoun County,351,51,44841.863636363705,2852,3203
1900,Tazewell County,345,17,25283.949152542373,2544,2889
1090,Lake County,341,39,32603.512195122014,3794,4135
1100,NA,341,6,17942.72727272727,2263,2604
1100,New London County,338,9,29763.33009708738,5338,5676
200,NA,337,15,22487.901098901097,2018,2355
190,Atlantic County,336,34,20687.731958762906,6580,6916
2200,Richland County,336,39,23935.882352941186,2783,3119
3600,York County,332,42,33290.78481012658,7522,7854
2900,Northwest Georgia Regional Commission,330,13,34407.90540540539,3050,3380
3300,NA,328,6,14091.014084507042,2967,3295
3900,Northeast Georgia Regional Commission,326,13,40558.47999999999,1561,1887
2600,Williamson County,326,47,33459.71875000001,2277,2603
400,NA,325,23,16372.647058823522,2147,2472
1490,Mahoning County,323,39,20629.98113207548,8428,8751
900,Jackson County,321,41,21057.599999999995,4701,5022
4000,Wayne County,317,37,19492.041237113404,3050,3367
2200,NA,317,21,21472.37209302326,2232,2549
1800,Hamilton County,316,18,38450.769230769234,4790,5106
3600,Clark County,314,18,23935.059999999998,1538,1852
1000,NA,313,16,25311.6923076923,2250,2563
1700,Warren County,311,34,30218.199999999983,1502,1813
4300,Jefferson County,308,48,23246.222222222223,5219,5527
5400,Butler County,307,39,27907.079999999998,7053,7360
51080,Central Shenandoah Planning District Commission,307,51,22690.8,2492,2799
2600,NA,307,36,16050.696969696975,2202,2509
200,Porter County,306,18,34746.40909090908,2952,3258
2890,Northampton,302,42,24407.999999999956,11997,12299
800,Canadian County,300,40,46467.53535353536,2719,3019
4300,Craven County,300,37,34644.80722891566,2410,2710
3000,Rockland County,298,36,27750.600000000002,2847,3145
200,NA,296,41,21391.5,1692,1988
1100,NA,296,42,27235.572916666668,2110,2406
100,Coastal Regional Commission,295,13,20086.075471698092,4273,4568
3100,Atlanta Regional Commission,292,13,27532.142857142866,3310,3602
2000,Caldwell & Alexander Counties,291,37,26893.735849056604,1960,2251
3100,Will County,285,17,35921.83333333334,8298,8583
200,West Montana,283,30,22594.24999999999,4522,4805
5301,Hernando County,279,12,30232.337349397592,2990,3269
2000,Calhoun & Barry Counties,277,26,24537.727272727272,4311,4588
800,"Sumter, Clarendon, Williamsburg & Lee Counties",277,45,22125.105263157897,3424,3701
2800,Dutchess County,275,36,33310.76470588235,4214,4489
3700,Heart of Texas COG,274,48,34415.142857142855,2922,3196
1200,NA,274,35,25689.54954954955,1796,2070
4100,Central Savannah River Area Regional Commission,272,13,32532.1489361702,1560,1832
1700,St. Charles County,272,29,35354.03921568627,6142,6414
700,"Lancaster, Chesterfield & Marlboro Counties",269,45,22047.710843373494,1603,1872
1200,"Greene, Carter, Unicoi & Johnson Counties",264,47,27153.090909090934,2267,2531
1700,Capital Region Planning Commission 6,263,22,32611.599999999984,1950,2213
55000,Chesapeake City,263,51,32880,4317,4580
190,Kootenai County,263,16,32270.02631578946,5458,5721
105,Rock Island County,261,17,18754.245614035088,3262,3523
2800,Catawba County,259,37,21823.67213114754,3550,3809
200,NA,258,46,28992.92,1432,1690
1400,"Wicomico, Worcester & Somerset Counties",257,24,19649.4,3449,3706
600,"Chisago, Isanti, Pine, Mille Lacs & Kanabec Counties",256,27,29627.3,2898,3154
4500,Northwest Georgia Regional Commission,255,13,28276.482758620725,2221,2476
2300,Bluegrass Area Development District,254,21,28352.986301369885,2941,3195
2000,Delaware County,254,18,21672.069767441862,2204,2458
300,Rockingham & Stokes Counties,253,37,22500.320000000014,2045,2298
2200,Buncombe County,250,37,23487.2,3196,3446
1600,Franklin County,249,29,30506.213483146068,1928,2177
590,"Crittenden, Mississippi & Craighead",248,5,21350.27777777778,7031,7279
900,Douglas County,248,31,26781.563218390806,13268,13516
2400,Parker County,244,48,35043.31578947368,1931,2175
2601,DeKalb County,243,17,23045.500000000007,2458,2701
900,NA,241,16,27690.52631578947,2095,2336
2400,Northern Kentucky Area Development District,240,21,31695.72413793104,3544,3784
400,NA,238,28,25099.818181818195,2217,2455
4200,Orange & Hardin Counties,237,48,37812.29702970297,2901,3138
3400,Chester County,236,42,32983,4544,4780
2500,Lebanon County,236,42,31820.51612903226,2600,2836
1900,Madison County,236,18,16819.702702702707,3314,3550
1400,NA,235,55,33728.242424242424,2471,2706
4900,Fort Bend County,231,48,40548.92105263159,7854,8085
300,Laramie & Albany Counties,231,56,29870.130434782608,3375,3606
400,"Robertson, Dickson, Cheatham & Hickman Counties",231,47,21938.16,3086,3317
2400,Dauphin County,230,42,28684.420000000002,5742,5972
600,Richland County,230,45,24445.263157894737,9604,9834
200,Coastal Regional Commission,229,13,24623.42105263152,3869,4098
2600,Northern Kentucky Area Development District,229,21,30670.000000000004,2812,3041
1800,Saratoga County,229,36,37141.01960784314,3329,3558
1500,Capital Region Planning Commission 3,227,22,25568.6551724138,7674,7901
200,NA,224,38,41075.249999999985,1569,1793
1400,Beaufort & Jasper Counties,220,45,26970.147368421043,3851,4071
500,NA,220,23,25059.333333333332,2247,2467
1200,Shelby County,218,1,30604.71111111111,2608,2826
1590,Tuscaloosa & Northport,217,1,21379.89285714286,3229,3446
390,St. Louis,215,27,23618.739130434853,5759,5974
5690,Clermont County,213,39,30618.705882352962,3499,3712
4500,Houston-Galveston Area Council,213,48,29887.999999999996,9104,9317
7300,Leon County,213,12,19781.88888888889,6095,6308
51085,Northern Shenandoah Valley Regional Commission,210,51,26790.68085106383,1961,2171
5300,Warren County,209,39,49379.7777777777,2663,2872
300,NA,209,41,19341.000000000004,2134,2343
1700,KIPDA Area Development District,208,21,25558.429906542067,17288,17496
6100,Alamo Area COG,203,48,33683.07692307693,2040,2243
51096,Virginia's Region 2000,203,51,19726.608108108103,2182,2385
2100,Cambria County,199,42,23945.697674418603,1559,1758
190,Northeast Oklahoma,199,40,27191.39130434788,8130,8329
2300,Three Rivers Regional Commission,199,13,21291.764705882353,2488,2687
700,"Dubuque, Buchanan, Jackson & Delaware Counties",197,19,32143.073170731703,2741,2938
4200,"Pickaway, Union & Madison Counties",195,39,31550.999999999993,2217,2412
800,"Josephine, Coos & Curry Counties",193,41,22981.31914893617,3426,3619
5100,Capital Area COG,192,48,34081.083333333336,2327,2519
11300,Yolo County,191,6,24422.719298245614,2823,3014
1900,"Bradley, McMinn & Polk Counties",190,47,25712.26229508198,3889,4079
300,Spartanburg County,190,45,22920.428571428576,6845,7035
1001,"Monroe, Randolph, Washington, Jefferson & Marion Counties",188,17,29368.59259259258,2784,2972
1500,St. Mary's & Calvert Counties,188,24,43829.27083333332,3170,3358
200,"Carson City, Lyon, Douglas & Storey Counties",187,32,33996.84210526312,3958,4145
1000,Mesa County,186,8,29897.00000000002,5159,5345
4100,Marin County,185,6,39082.12345679013,2457,2642
2000,Southwest Arkansas,184,5,25463.44827586206,1864,2048
800,St. Clair & Blount Counties,184,1,33969.58490566036,2181,2365
3300,Vanderburgh County,183,18,23871.677083333336,4323,4506
800,Baltimore City,182,24,26034.75862068968,12629,12811
55102,St. Croix & Dunn Counties,182,55,31766.940828402367,2664,2846
1100,Cass & Bates Counties,181,29,29340.666666666668,2204,2385
3300,Georgia Mountains Regional Commission,181,13,39656.72131147541,2479,2660
1900,South Central Planning & Development Commission 1,177,22,23678.462365591397,1707,1884
6000,Alamo Area COG,176,48,25010.8,2057,2233
2700,"Greene, Daviess, Owen, Orange & Martin Counties",175,18,34370.545454545456,2510,2685
3300,Monroe County,174,26,30406.53846153846,2520,2694
11800,Kitsap County,172,53,27856.26666666667,5637,5809
3400,Rowan County,172,37,20263.000000000004,2022,2194
1900,South Region,171,28,28687,3031,3202
1200,Yamhill & Polk Counties,171,41,29090.211267605635,2918,3089
300,NA,170,32,29683.1929824561,3950,4120
3500,Belmont & Jefferson Counties,169,39,19882.000000000015,2266,2435
2600,West Central Texas COG,168,48,22472.042857142827,2402,2570
500,NA,168,26,26914.34782608696,2230,2398
1200,Acadiana Regional Development District 3,167,22,25079.030303030304,5629,5796
300,Coastal Regional Commission,167,13,27229.422222222223,2185,2352
3500,NA,166,13,26880,1244,1410
1500,Macon County,164,17,23484.405797101448,2747,2911
200,NA,164,37,24101.526315789473,1133,1297
3600,NA,164,39,22885.714285714286,1539,1703
2400,Rock County,163,55,20662.222222222223,3839,4002
51187,Norfolk City,160,51,21287.142857142862,10734,10894
100,"Maui, Kalawao & Kauai Counties",159,15,34216.46153846153,3976,4135
600,Mohave & La Paz Counties,157,4,23425.838709677442,5712,5869
2300,NA,156,19,19774.666666666668,1587,1743
2800,"Marion, Knox & Morrow Counties",151,39,26530.399999999998,2548,2699
1600,Butler County,150,42,29787.135135135133,2131,2281
800,Pinal County,150,4,26550.764705882328,9802,9952
900,Etowah County,148,1,28576.59999999993,2077,2225
1500,Middle Georgia Regional Commission,148,13,29597.720000000005,3520,3668
2890,Winnebago County,147,17,22693.0705882353,8433,8580
200,NA,146,54,24111.843137254906,2058,2204
3200,Rio Grande COG & Permian Basin Regional Planning Commission,143,48,49027.36363636364,2118,2261
300,Honolulu County,142,15,32912.105263157915,17060,17202
2300,Wilson County,142,47,36532.588235294104,1877,2019
1500,Outagamie County,141,55,28649.87356321839,2917,3058
200,NA,141,20,32129.367521367534,2845,2986
300,Monongalia & Preston Counties,140,54,24218.444444444438,1307,1447
400,"Otsego, Schoharie, Oneida",139,36,21831.500000000022,5749,5888
200,Washington County,139,24,28532.695652173916,3150,3289
100,"Ohio, Marshall, Hancock & Brooke Counties",138,54,26026.285714285692,1692,1830
100,Alachua County,135,12,20236.42857142857,4600,4735
4690,New Hanover County,135,37,19492.733333333334,4645,4780
600,Harford County,133,24,41277.074999999975,3326,3459
400,NA,133,35,16307.999999999985,2129,2262
200,NA,131,26,32640.57894736843,2234,2365
2102,Johnson County,128,48,27970.658227848104,2900,3028
4300,Clark County,127,39,23591.47368421052,3383,3510
2101,Ellis County,124,48,29059.125,3319,3443
900,Nash & Edgecombe Counties,124,37,19941,2998,3122
2700,Buffalo Trace & Gateway Area Development Districts,123,21,21908.58000000001,2054,2177
2800,Northwest Georgia Regional Commission,123,13,27042.780487804877,3423,3546
200,Northeast Nebraska,122,31,27518.254437869822,3623,3745
3100,"Dearborn, Franklin, Ripley, Switzerland & Ohio Counties",121,18,23459.241379310337,1808,1929
3500,"Floyd, Harrison & Washington Counties",120,18,24690.44999999997,2216,2336
1300,Acadiana Regional Development District 5,119,22,25327.21794871795,3126,3245
5700,Alamo Area COG,119,48,30650.478723404256,1869,1988
1100,Johnston County,119,37,24569.518867924526,2729,2848
2800,NA,117,47,19033.666666666668,1329,1446
1000,NA,116,48,21358.884615384588,3343,3459
3000,NA,116,39,28821.222222222223,2044,2160
790,South Maine,115,23,27117.948717948704,9115,9230
3200,Georgia Mountains Regional Commission,114,13,23565.722222222223,1441,1555
10200,"Skagit, Island & San Juan Counties",113,53,29253.590909090908,5267,5380
1300,Story & Boone Counties,113,19,34263.06122448979,1754,1867
5500,Golden Crescent Regional Planning Commission,112,48,35284.5,2240,2352
1701,Peoria County,111,17,22453.636363636364,3853,3964
2400,Chemung,107,36,27058.166666666668,3135,3242
1200,Centre County,106,42,29498.874999999996,1444,1550
2900,Oakland County,105,26,31239.583333333332,18534,18639
1100,Acadiana Regional Development District 2,104,22,29070.53846153846,2005,2109
1600,Charles County,104,24,38639.59615384615,2493,2597
1100,"Ionia, Montcalm, Mecosta & Osceola Counties",102,26,25759.25,2956,3058
4000,NA,100,48,22768.69230769231,3290,3390
1500,Windham County,99,9,39597.46808510638,2160,2259
100,NA,99,36,18320.999999999993,1781,1880
2200,"Wapello, Mahaska, Washington, Jefferson, Keokuk, Davis & Van Buren Counties",98,19,30331.42857142863,2271,2369
1300,Jefferson County,97,1,23241.49999999997,13969,14066
1500,NA,97,28,30470.965517241377,1758,1855
400,"Bremer, Winneshiek, Fayette, Clayton, Allamakee, Chickasaw & Howard Counties",96,19,27070.499999999993,1585,1681
900,Southwest Georgia Regional Commission,96,13,22747.418181818182,3098,3194
4900,"Jackson, Hocking, Pike & Vinton Counties",95,39,21193.031249999996,1714,1809
702,Sarpy County,94,31,37870.68,3829,3923
2300,NA,90,1,25000.81818181818,2112,2202
290,Hampden County,89,25,26787.999999999967,10571,10660
1400,NA,88,18,22206.88235294117,2951,3039
3400,Georgia Mountains Regional Commission,87,13,25337.19512195123,3268,3355
2501,"Knox, Stark, Bureau, Marshall & Woodford Counties",87,17,32031.459459459456,1739,1826
2600,"Winona, Wabasha, Fillmore & Houston Counties",86,27,44413.7142857143,1465,1551
2700,"Maury, Bedford & Marshall Counties",85,47,18131.571428571428,3545,3630
100,NA,85,31,28144.44943820223,2012,2097
300,"Baxter, Boone, Carroll, Marion, Madison, Newton & Searcy Counties",84,5,23135.964912280702,3153,3237
1700,Vigo County,84,18,20076.000000000004,2076,2160
2200,Broome County,83,36,25032.5,5302,5385
5500,Hamilton County,82,39,20628.692307692287,20309,20391
10700,"Walla Walla, Benton",82,53,31579.69811320757,6338,6420
3800,Heart of Texas COG,81,48,23409.695652173912,5965,6046
1300,"Queen Anne's, Talbot, Caroline, Dorchester & Kent Counties",81,24,27678.80952380952,2878,2959
1400,Mercer County,80,42,35165.810810810806,1417,1497
3200,"Warrick, Gibson & Posey Counties",80,18,29116.000000000007,1868,1948
100,NA,80,39,26398.385964912275,2207,2287
3400,NA,77,39,26276.605633802817,2676,2753
200,NA,76,27,12011.533333333335,1298,1374
21001,Southwest & South Central Utah,75,49,22196.090909090904,2115,2190
2200,"Livingston, Ford, Iroquois & Vermilion Counties",74,17,27944.222222222244,3514,3588
600,NA,74,17,22160,2133,2207
1200,NA,72,29,23108.383838383837,2643,2715
4800,Brunswick County,71,37,20656.711111111104,2387,2458
11000,Davis County,71,49,35839.53333333333,4920,4991
1400,Ontario & Yates Counties,71,36,25605.714285714283,2098,2169
500,NA,70,9,35605.563829787236,2741,2811
1300,"Laclede, Polk, Benton, Dallas & Hickory Counties",69,29,33673.882978723406,2252,2321
100,NA,67,23,18746.7,1456,1523
1100,Monmouth County,65,34,32541.52830188679,6532,6597
500,Wyandotte County,65,20,18183.96296296297,4325,4390
900,Hunt & Rockwall Counties,63,48,40618.72093023257,2953,3016
100,NA,63,19,32505.325581395344,2475,2538
1500,Green River Area Development District,61,21,24760.844155844152,2118,2179
200,"Buchanan, Andrew & DeKalb Counties",60,29,22867.629629629628,2217,2277
5000,Houston-Galveston Area Council,60,48,28747.352000000003,2565,2625
1400,Green River Area Development District,59,21,23584.48148148148,2176,2235
2200,Regional Planning Commission 1,59,22,26369.58928571429,4120,4179
51020,Mount Rogers Planning District Commission,57,51,15946.875000000013,2619,2676
500,"Pike, Wayne & Susquehanna Counties",57,42,30120.586206896533,1993,2050
700,West Central Wisconsin,56,55,27400,3787,3843
100,NA,56,26,21274.905172413797,1947,2003
900,NA,56,8,25227.661016949154,2010,2066
1600,NA,56,26,19547.157894736847,2232,2288
1200,East Texas COG,53,48,26801.52777777779,1863,1916
800,"Grant, Green, Iowa, Richland & Lafayette Counties",53,55,29309.166666666668,2096,2149
800,NA,50,37,29887.060975609755,1563,1613
1000,Linn County,48,19,33065,3678,3726
1600,NA,48,45,21812.352941176476,1898,1946
2000,Woodbury & Plymouth Counties,47,19,29673.609890109892,2652,2699
1500,NA,47,5,23475.2,1577,1624
2400,NA,47,39,31065.574468085117,2308,2355
500,Black Hawk County,46,19,37989.88079470199,2655,2701
70100,Waukesha County,46,55,37850.000000000015,5761,5807
1400,"Hamblen, Cocke & Grainger Counties",45,47,24982.533333333336,1878,1923
100,Lake County,44,18,26051.117647058825,10388,10432
700,Southern Georgia Regional Commission,44,13,28337.52173913043,1851,1895
1701,Citrus County,43,12,18338.444444444445,2543,2586
5300,Monterey County,42,6,29232.666666666668,6195,6237
100,Erie County,40,42,19401.638297872327,4765,4805
104,NA,40,17,26074.956521739132,2528,2568
2800,Monroe County,39,18,18021.403669724772,2372,2411
1300,NA,38,13,21984.785714285717,2049,2087
2700,NA,38,17,28793.739130434784,2358,2396
1100,"Montgomery, Clinton, White, Carroll & Benton Counties",37,18,36452.260869565216,2737,2774
100,NA,37,20,29537.671641791047,2202,2239
300,NA,37,42,26671.760869565216,2321,2358
1900,NA,35,5,20134.33333333334,1711,1746
1200,Bonneville County,33,16,34257.38461538462,2111,2144
11100,Ventura County,33,6,32740.244897959183,12437,12470
2000,Hamilton County,32,47,24702.999999999996,7033,7065
800,Southwest Georgia Regional Commission,32,13,17197.89830508475,2153,2185
1700,Genesee,30,26,21721.777777777777,12389,12419
2000,NA,30,39,23250.899999999998,2070,2100
3700,NA,30,37,22922.581395348847,1442,1472
1400,Bay & Midland Counties,29,26,29396.714285714286,2774,2803
100,NA,29,21,21360.32352941177,2883,2912
600,Androscoggin County,28,23,33461.444444444445,2358,2386
590,Southeast South Dakota,28,46,30805.024390243932,6973,7001
2100,Collier County,27,12,31436.555555555555,5874,5901
35000,Salt Lake County,26,49,33890.588235294126,21123,21149
600,NA,26,26,22996.66666666667,2287,2313
300,Central Nebraska,25,31,24844.31250000001,2170,2195
2500,Henderson & Transylvania Counties,24,37,17585.606557377047,2643,2667
1300,"Pope, Johnson, Yell, Conway & Perry Counties",24,5,27755.600000000002,2608,2632
8700,Santa Cruz County,24,6,32213.166666666664,2898,2922
10900,Yakima County,24,53,25006.678899082573,5427,5451
2300,NA,23,6,23474.45945945946,2676,2699
900,New Haven County,22,9,23547.483870967746,12803,12825
500,South Central Montana,19,30,25744.186046511626,2272,2291
700,"St. Francis, Poinsett, Phillips, Cross, Lee & Monroe Counties",19,5,21881.647058823524,2291,2310
1000,NA,19,1,17549.27999999999,2965,2984
1300,NA,19,42,26937.500000000004,1817,1836
11000,"Lewis, Klickitat & Skamania Counties",18,53,25770.38235294118,2138,2156
500,NA,18,33,30621.304347826088,2204,2222
10700,Tulare County,16,6,27000.576923076922,7662,7678
400,Carroll County,14,24,45435.902439024394,1555,1569
400,NA,14,42,35249.736842105274,1205,1219
2500,Olmsted County,13,27,29538.880597014926,2671,2684
600,Southern Georgia Regional Commission,13,13,25143.405797101455,2878,2891
2700,West Central Texas COG,12,48,27629.079999999998,4136,4148
900,Lycoming & Clinton Counties,11,42,22464.19672131151,2820,2831
2200,NA,11,26,25840.777777777785,2049,2060
100,Berkshire County,10,25,20082.277777777777,1731,1741
2800,Concho Valley COG & Permian Basin Regional Planning Commission,8,48,28844.26446280992,2042,2050
100,NA,8,29,24239.8,1857,1865
1690,Scott County,7,27,31473.25581395349,3197,3204
2200,"Cape Girardeau, Scott & Bollinger Counties",6,29,17514.345794392524,2467,2473
2300,"Rice, Goodhue & Le Sueur Counties",6,27,32651.610169491527,2714,2720
2100,Burke & McDowell Counties,5,37,36028.42372881356,1576,1581
1800,NA,5,48,29899.41176470588,1989,1994
2500,NA,5,29,17420.011235955055,2123,2128
890,Imperial Calcasieu Regional Planning & Development District 2,4,22,24841.58666666667,6485,6489
900,Stearns County,3,27,29342,3182,3185
1300,Livingston & Wyoming Counties,1,36,23721.608695652187,1296,1297
1000,NA,0,37,18807.631578947367,1860,1860
300,NA,-3,50,29302.453947368416,1546,1543
1990,"Davie, Yadkin & Iredell",-5,37,29891.454545454544,3722,3717
12100,NA,-5,12,16421.015624999996,1568,1563
300,NA,-7,29,27153.947368421053,2311,2304
800,Columbia & Luzerne,-9,42,27518.262295081968,6428,6419
202,"Henry, Mercer, Henderson, Warren, Hancock, McDonough & Fulton Counties",-9,17,28442.533980582524,2227,2218
1600,Marathon County,-9,55,21594.000000000022,2430,2421
1800,South Region,-9,28,21880.472727272718,4107,4098
4500,NA,-9,39,29761.40594059406,3260,3251
700,Lackawanna,-10,42,27584.701492537322,3495,3485
1700,Portage County,-10,39,36387.611650485436,2892,2882
2000,South Central Planning & Development Commission 2,-10,22,61872.3469387755,1547,1537
400,Coconino County,-11,4,38103.11538461538,2252,2241
500,"Columbia, Lincoln, Clatsop & Tillamook Counties",-12,41,25345.499999999996,3399,3387
1200,Erie County,-12,36,24888.570093457944,13097,13085
400,North Delta Regional Planning & Development District 1,-13,22,25707.09090909094,2365,2352
2200,Gloucester County,-14,34,27969.700000000023,3602,3588
900,Monroe County,-15,36,23059.565217391304,12508,12493
9700,Osceola County,-15,12,23310.541666666668,4934,4919
1000,Genesee & Orleans Counties,-16,36,30026.20930232558,1926,1910
900,Brevard County,-20,12,25650.70731707314,10916,10896
700,Middlesex County,-21,9,47962.83157894736,2152,2131
500,Santa Fe County,-23,35,24324.800000000003,1936,1913
1602,"Menard, Logan, De Witt, Piatt, Moultrie, Shelby & Christian Counties",-24,17,40475.77272727274,3149,3125
1300,Tolland County,-24,9,33838.70212765957,1676,1652
400,"Cherokee, Newberry, Chester & Union Counties",-26,45,31316.111111111088,2158,2132
51095,Virginia's Region 2000,-26,51,41137.76315789473,1565,1539
2600,"Wayne, Fayette, Rush & Union Counties",-26,18,25847.07692307693,2349,2323
1500,Beaver County,-27,42,24109.37499999997,4088,4061
400,"Natrona, Carbon & Converse Counties",-27,56,45249.87096774195,2840,2813
800,South & Southeast Illinois,-29,17,41902.000000000044,2056,2027
1501,Winnebago County,-29,55,29012.666666666668,2869,2840
51186,Hampton City,-31,51,24152.181818181823,4619,4588
1600,Middle Georgia Regional Commission,-31,13,22394.689655172413,3574,3543
2700,Ulster County,-32,36,22019.85714285714,3848,3816
49000,Utah County,-33,49,35157.5,8034,8001
2600,NA,-34,39,33118.85294117647,1966,1932
6200,NA,-34,48,25970.16923076923,2767,2733
200,NA,-35,21,21601.819672131147,2085,2050
100,NA,-37,56,29431.964285714294,2313,2276
100,Larimer County,-38,8,27627.340425531922,6709,6671
100,Allegany & Garrett Counties,-40,24,25296.755102040825,1480,1440
100,NA,-43,41,26363.97222222222,3127,3084
800,"Clinton, Muscatine, Jones & Cedar Counties",-44,19,28705.71428571431,2248,2204
300,Pennyrile Area Development District,-44,21,25658.14,2617,2573
300,NA,-44,35,21530.285714285714,805,761
2600,Jackson County,-45,26,22906.95,3349,3304
51087,Rappahannock-Rapidan Regional Commission,-46,51,32141.402173913044,2491,2445
800,NA,-46,18,26711.821138211384,2580,2534
2000,McLean County,-47,17,25013.50000000002,2465,2418
4000,Washington County,-47,42,30868.205128205125,3576,3529
400,NA,-47,50,27877.30769230769,1349,1302
600,NA,-51,28,12871.758620689647,2700,2649
2300,NA,-51,29,16324.681818181807,2321,2270
600,Oswego County,-53,36,26806.388888888894,1889,1836
600,NA,-53,18,28160.571428571464,3395,3342
1300,"Howard, Cass & Tipton Counties",-54,18,23064.500000000004,3064,3010
51206,"James City, York Counties, Williamsburg & Poquoson Cities",-54,51,29128.215686274514,2883,2829
1000,NA,-54,20,24106.04761904762,2857,2803
1300,NA,-54,48,24773.843749999996,1795,1741
1500,Aiken & Edgefield Counties,-55,45,24958.666666666624,3485,3430
2600,Northwest Georgia Regional Commission,-55,13,25695.897435897437,3114,3059
2900,Orange County,-56,36,32188.761904761905,4318,4262
800,NA,-56,21,21943.111111111095,1830,1774
6100,Placer County,-57,6,35762.25352112676,6100,6043
500,North Delta Regional Planning & Development District 2,-59,22,11344.875,1363,1304
900,"Huntington, Whitley, Adams & Wells Counties",-61,18,27186.4,2970,2909
900,Howard County,-63,24,45919.285714285674,3041,2978
200,Kent County,-63,10,27384.837209302324,2966,2903
4000,Delaware County,-64,39,38290.25806451613,1721,1657
1100,Niagara County,-64,36,26111.692307692305,2858,2794
100,Northwest Vermont,-65,50,32129.117647058785,2716,2651
3800,NA,-65,42,22368.49166666667,1600,1535
2200,North Central Texas COG,-67,48,32001.000000000004,2336,2269
1800,"Roane, Loudon & Monroe Counties",-67,47,27186.376470588246,2478,2411
2800,Jasper & Newton Counties,-68,29,31036,3611,3543
2300,Marion County,-68,18,23113.21428571427,21380,21312
2200,Hendricks County,-70,18,33509.34146341463,3344,3274
300,Montgomery & Stewart Counties,-70,47,27458.136986301382,7021,6951
600,Morgan & Lawrence Counties,-70,1,21277.183544303796,3262,3192
700,NA,-70,21,14608.179775280898,1814,1744
3700,Adams & Franklin,-72,42,30947.797202797203,5367,5295
1900,NA,-73,19,22123.222222222208,2399,2326
1290,Lincoln Trail Area Development District,-74,21,24350.624999999996,6740,6666
2100,Bluegrass Area Development District,-75,21,25243.35616438356,2665,2590
1301,Manitowoc & Kewaunee Counties,-75,55,25318.127659574468,1487,1412
700,Cecil County,-78,24,37399.52475247525,1570,1492
11900,NA,-78,53,21623.529411764714,1735,1657
5600,Golden Crescent Regional Planning Commission,-79,48,29383.222222222223,3022,2943
900,NA,-80,21,18181.959459459464,1335,1255
1900,Medina County,-81,39,31712.02702702705,2617,2536
10100,Pasco County,-81,12,29340.545454545452,7097,7016
3400,NA,-82,18,26775.641791044774,2418,2336
200,"Cherokee, Sequoyah & Adair Counties",-83,40,17854.6,2047,1964
800,NA,-83,5,30648.451612903224,2242,2159
1700,East Texas COG,-85,48,23552.513513513513,2050,1965
51084,Northern Shenandoah Valley Regional Commission,-86,51,31439.000000000015,2379,2293
400,NA,-86,40,21963.076923076926,2190,2104
2500,Hancock & Shelby Counties,-88,18,37764.846715328466,1673,1585
200,NA,-88,19,28193.00000000002,2046,1958
1600,NA,-89,36,27183.63265306122,1957,1868
3800,Northeast Georgia Regional Commission,-91,13,37371.47619047617,2081,1990
5100,Scioto & Lawrence Counties,-91,39,26137.93333333332,2207,2116
1900,Three Rivers Regional Commission,-92,13,23127.111111111117,2546,2454
2200,Three Rivers Regional Commission,-93,13,27390.983606557376,2099,2006
2100,NA,-93,27,22976.43842364532,2135,2042
2100,NA,-93,39,35438.5,2347,2254
400,Northeast North Dakota,-94,38,39491.83620689654,2491,2397
2400,"Russell, Pike, Barbour, Macon & Bullock Counties",-94,1,16673.64705882353,3556,3462
1400,Capital Region Planning Commission 1,-97,22,27603.465517241384,1743,1646
1000,Northumberland & Montour Counties,-97,42,37818.90291262136,1662,1565
10600,"Whitman, Asotin, Adams, Lincoln, Columbia & Garfield Counties",-97,53,24447.446808510635,1984,1887
1500,Morris County,-98,34,33535.06451612904,3398,3300
800,Wayne & Seneca Counties,-99,36,23349.428571428587,1988,1889
2100,Three Rivers Regional Commission,-101,13,30354.590909090908,2470,2369
2900,NA,-101,47,22468.533333333293,1459,1358
1400,NA,-102,28,16550.272727272735,1435,1333
2400,NA,-102,29,23898.260869565216,2035,1933
2300,Tompkins County,-104,36,25142.26086956521,1397,1293
400,NA,-104,1,21953,1900,1796
400,North Central Montana,-106,30,21029.552238805973,3467,3361
1000,Sherburne & Benton Counties,-106,27,31909.196428571442,2211,2105
700,"Wood, Pleasants & Wirt Counties",-106,54,18131.28205128205,1681,1575
600,NA,-106,54,19097.595238095237,1000,894
900,Pulaski County,-108,5,26071.151515151512,8662,8554
600,"Webster, Hardin, Hamilton, Butler, Wright, Grundy, Franklin & Humboldt Counties",-108,19,29771.181818181816,2245,2137
2700,Northwest Georgia Regional Commission,-109,13,25189.810810810806,2077,1968
1325,Portland City,-111,41,25314.622950819674,17039,16928
400,NA,-111,26,26004.095890410958,3086,2975
400,Northeast Kansas,-113,20,27473.234042553187,1873,1760
900,Scott County,-113,19,24234.478723404263,2723,2610
300,NA,-113,4,20911.757575757612,2313,2200
6400,NA,-114,48,13245.500000000002,1294,1180
2300,"Columbia, Levy, Bradford, Gilchrist, Dixie & Union Counties",-115,12,21493.217391304348,3194,3079
1400,Kaufman County,-120,48,34853.18181818182,2187,2067
10300,Chelan & Douglas Counties,-121,53,21209.727272727272,1697,1576
40100,Milwaukee City,-123,55,21924.571428571424,23729,23606
600,NA,-127,21,21243.55319148936,1815,1688
1500,Dakota County,-128,27,40317.10377358491,8260,8132
1190,Southeast Idaho,-129,16,21880.249999999985,4427,4298
2500,Allen County,-130,39,20969.40594059406,2672,2542
4700,Greene County,-130,39,22279.53488372093,2941,2811
2300,Van Buren & Cass Counties,-131,26,33818.938356164384,2412,2281
400,"Granville, Person & Caswell Counties",-132,37,32128.899999999998,2018,1886
8900,Nassau & Baker Counties,-132,12,32562.45161290323,2141,2009
300,Warren & Washington Counties,-133,36,21558.400000000012,2425,2292
401,"Cass, Morgan, Scott, Greene, Macoupin, Jersey & Calhoun Counties",-134,17,25975.757575757576,2824,2690
55100,Eau Claire & Chippewa,-134,55,30778.805970149253,5239,5105
1200,Washington County,-134,27,40215.25,2889,2755
2900,Bartholomew & Jackson Counties,-135,18,35982.07692307692,2351,2216
3900,Fairfield County,-135,39,33567.88679245286,3247,3112
300,Southeast Rhode Island,-135,44,39628.666666666664,2044,1909
4800,NA,-137,39,28558.942307692305,1975,1838
2600,Baldwin County,-138,1,27880,2738,2600
700,Northeast Albemarle Sound Region,-139,37,27245.196969696968,2326,2187
300,Penobscot County,-141,23,15631.893617021278,3033,2892
8900,Shasta County,-141,6,22401.679999999986,3138,2997
600,Hudson County,-143,34,25540.538461538432,9414,9271
2100,Southwest Iowa,-143,19,29580.689655172417,3496,3353
200,Northeast Region,-145,28,24475.359999999993,2702,2557
700,NA,-145,17,25522.173913043498,1682,1537
1000,NA,-145,22,19953.964285714286,1603,1458
3000,"Jefferson, Jennings, Decatur & Scott Counties",-146,18,29831.076923076922,2287,2141
1800,St. Louis County,-146,29,22619.658119658117,18543,18397
51001,Thomas Jefferson Planning District Commission,-147,51,28204.105263157893,3078,2931
900,NA,-148,26,47017.470588235294,1830,1682
1500,Madison & Cortland Counties,-150,36,22336.367346938776,1686,1536
10400,"Stevens, Okanogan, Pend Oreille & Ferry Counties",-153,53,21428.489361702133,1673,1520
3300,Delaware County,-155,42,28735.441176470587,5643,5488
51125,"Middle Peninsula, Northern Neck & Accomack-Northampton Planning District Commissions",-156,51,28572.40816326531,1680,1524
200,NA,-158,8,27559.451612903227,2583,2425
200,NA,-158,47,17519.172413793105,2410,2252
1100,Johnson County,-159,19,28248.837209302324,1941,1782
1600,Sussex County,-159,34,48468.333333333256,1823,1664
200,Pima County,-162,4,22916.333333333332,27289,27127
200,NA,-162,42,16981.431818181816,2013,1851
3602,Brazos Valley COG,-163,48,20409.285714285717,4475,4312
100,Northwest Tennessee,-168,47,23921.50000000002,2761,2593
1300,Sangamon County,-169,17,25588.63157894749,4445,4276
51256,Prince William County,-170,51,31353.03225806455,9504,9334
990,South Central Kansas,-171,20,23945.62162162163,5060,4889
13001,NA,-174,49,21160.249999999993,2145,1971
190,Northwest New Mexico,-175,35,19182.105263157933,2949,2774
600,North Texas Regional Planning Commission,-176,48,29960.830508474577,3431,3255
700,NA,-176,27,27823.130434782597,3058,2882
1100,Calhoun County,-177,1,21046.00000000002,2669,2492
51145,"Isle of Wight, Southampton Counties, Suffolk & Franklin Cities",-178,51,26675.219999999998,3043,2865
100,"Clay, Polk, Roseau, Pennington, Marshall, Norman, Kittson & Red Lake Counties",-179,27,26407.283582089556,2226,2047
51215,"Hanover, Powhatan, Goochland, New Kent, King William & Charles City Counties",-179,51,40730.549019607846,2689,2510
1790,"Jefferson, Grant & Arkansas",-179,5,17548.476190476194,3469,3290
1900,"Kandiyohi, McLeod, Meeker, Renville & Sibley Counties",-179,27,43809.14285714285,2452,2273
1800,South Central Iowa,-179,19,23318.53571428571,2177,1998
1800,River Valley Regional Commission,-180,13,17824.657142857133,3627,3447
1400,Middle Georgia Regional Commission,-181,13,14691.962962962964,3596,3415
1200,NA,-182,26,20592.40322580645,2733,2551
1100,NA,-183,54,33195.07692307692,1601,1418
3000,Bucks County,-186,42,32641.428571428576,6715,6529
3290,Cabarrus County,-186,37,19645.64788732394,4877,4691
501,"Montgomery, Bond, Clinton, Fayette & Effingham Counties",-188,17,28435.94444444446,2218,2030
900,Cochise & Santa Cruz Counties,-191,4,20987.857142857138,3592,3401
300,NA,-191,26,23565,2860,2669
1200,Saline County,-192,5,35327.40983606557,1359,1167
1200,NA,-192,20,30645.200000000008,2840,2648
700,NA,-193,29,22346.685714285715,2459,2266
2300,Mercer County,-194,34,27351.3962264151,4406,4212
1000,NA,-194,45,10736.17171717172,2537,2343
4400,Atlanta Regional Commission,-195,13,26421.724137931036,3156,2961
5000,NA,-195,39,28097.648148148146,1598,1403
4790,Barnstable County,-196,25,27423.74468085107,2783,2587
700,"Jasper, Starke, Fulton, Newton & Pulaski Counties",-199,18,32128.416666666664,1624,1425
2500,Imperial County,-200,6,18945.6724137931,3382,3182
1800,Summit County,-200,39,25132.95652173912,6450,6250
3700,Muskingum & Perry Counties,-201,39,28917.677419354837,2456,2255
100,NA,-204,30,26934.000000000004,1738,1534
600,NA,-204,55,23087.731707317074,1779,1575
1500,NA,-207,20,23455.000000000022,2480,2273
800,Lorain County,-209,39,26386.999999999996,6484,6275
3200,DuPage County,-211,17,36102.07865168539,12115,11904
2500,"Houston, Dale, Geneva & Henry Counties",-214,1,22120.000000000004,4424,4210
3190,Stark County,-214,39,24311.18644067797,7521,7307
500,Elkhart County,-216,18,33131.622641509435,4048,3832
900,Southwest New Mexico,-218,35,24235.943661971836,1629,1411
51097,NA,-218,51,20823.600000000002,3728,3510
600,"Warren, Macon, Smith, DeKalb, Cannon & Trousdale Counties",-219,47,25528.347826086963,2206,1987
5000,Cumberland County,-221,37,24945.1219512195,10673,10452
400,South Plains Association of Governments,-223,48,25465.85185185185,3219,2996
2100,"Rhea, Marion, Sequatchie, Grundy, Bledsoe & Meigs Counties",-224,47,24758.372881355932,1595,1371
400,NA,-224,5,24029.125000000004,2361,2137
700,NA,-224,1,21961.25773195876,1150,926
200,NA,-225,50,19779.2,2355,2130
400,NA,-225,46,21858.217391304348,2445,2220
1000,NA,-225,21,26284.397727272728,1376,1151
2100,Champaign County,-227,17,22332.78632478632,2638,2411
2500,NA,-228,36,27107.739130434788,1971,1743
4190,"Lenoir, Onslow",-230,37,25525.999999999996,7978,7748
5700,NA,-231,6,21760.44186046512,1450,1219
4400,"Carteret, Beaufort & Pamlico Counties",-232,37,27569.79310344826,2306,2074
3600,Randolph County,-232,37,21645.85714285714,2565,2333
300,Coordinating & Development Corporation 4,-233,22,23644.6511627907,2625,2392
3900,Madera County,-235,6,41775.085106382976,1973,1738
100,Stamford & Greenwich Towns,-237,9,22782.204819277114,11173,10936
300,"West Hartford, Farmington, Simsbury, Bloomfield, Avon & Canton Towns",-238,9,26318.625000000007,14210,13972
700,NA,-238,47,19506.890410958895,2089,1851
2700,Mobile City,-240,1,24261.285714285717,7803,7563
1200,"Marshall, Benton, Poweshiek, Tama & Iowa Counties",-241,19,29182.412698412696,2071,1830
2800,FIVCO Area Development District,-246,21,23353.829999999998,2458,2212
7900,San Luis Obispo County,-247,6,34433.76288659794,3871,3624
700,NA,-247,39,33255.37777777777,2625,2378
11200,"Cowlitz, Pacific & Wahkiakum Counties",-248,53,25319.905660377353,3417,3169
2700,NA,-250,39,30292.076923076922,2905,2655
100,NA,-253,33,36788.470588235294,2056,1803
1300,"Marinette, Oconto, Door & Florence Counties",-255,55,24913.822222222225,2075,1820
2100,South Region,-255,28,25988.415094339623,2990,2735
4400,Houston-Galveston Area Council,-257,48,31051.42857142857,2039,1782
800,Ottawa County,-259,26,30832.6,3726,3467
51105,Southside Planning District Commission & Commonwealth Regional Council,-262,51,24727.374999999996,2202,1940
1500,NA,-272,18,26845.20987654319,2280,2008
900,Cuyahoga County,-276,39,23955.637931034486,27812,27536
2690,Lincoln & Cleveland,-276,37,18290.333333333332,3982,3706
11300,NA,-277,53,33251.87640449438,2239,1962
300,North Delta Region,-278,28,10841.076923076927,1937,1659
700,NA,-279,28,17878.86486486487,1774,1495
4990,NA,-282,37,23193.897959183676,3132,2850
1800,Wright County,-284,27,41465.949999999975,2591,2307
2300,NA,-284,39,22120.878787878788,2719,2435
700,Douglas County,-286,20,22575.75,2017,1731
1400,Orange County,-286,37,28486.530612244896,1689,1403
200,NA,-287,23,19756.25,2251,1964
1300,NA,-288,45,17898.882352941182,2467,2179
1500,NA,-288,6,19073.163636363635,2629,2341
2400,NA,-288,17,28800.74074074075,2328,2040
1100,St. Clair County,-289,17,25865.749999999905,5369,5080
1700,Blount County,-291,47,21169.983333333334,1995,1704
3100,Kings County,-291,6,25799.113924050627,3735,3444
2000,NA,-292,27,27825.285714285714,2045,1753
1100,NA,-293,21,20069.428571428572,2104,1811
1700,NA,-295,28,22498.525423728817,1527,1232
600,Kisatchie Delta Regional Planning & Development District 1,-297,22,14088.64179104477,2070,1773
800,NA,-302,28,15928.857142857141,2244,1942
200,NA,-303,56,34492.52380952381,3424,3121
1100,Ark-Tex COG,-304,48,14130.387387387387,2172,1868
400,Barren River Area Development District,-304,21,25269.945054945056,2876,2572
51000,Roanoke Valley-Alleghany Regional Commission,-304,51,22261.910714285703,7967,7663
3900,Fayette County,-310,42,26109.65789473684,2150,1840
1300,Washington County,-312,47,33661.81818181818,1898,1586
5200,NA,-314,39,18856.863636363643,2153,1839
4100,Deep East Texas COG,-319,48,17313.183098591544,1725,1406
1000,Somerset County,-320,34,38680.28571428572,2087,1767
300,Central Idaho,-322,16,21782.727272727287,1979,1657
300,NA,-324,30,19586.764705882357,3576,3252
600,Sandoval County,-325,35,30826.8,1837,1512
500,Sumner County,-327,47,31448,3432,3105
4200,Central Savannah River Area Regional Commission,-334,13,12732.47058823528,2315,1981
1900,Indiana & Armstrong Counties,-335,42,26918.0303030303,2187,1852
500,NA,-336,56,43588.33333333333,3595,3259
5001,"Cache, Summit, Morgan & Rich Counties",-341,49,28114.117647058825,2517,2176
700,Butte County,-345,6,20170.604651162794,4680,4335
3300,Lake County,-350,17,28012.43421052629,11138,10788
6900,NA,-351,48,30951.705882352944,1701,1350
1300,NA,-356,54,24774.463768115937,1149,793
3600,McHenry County,-360,17,36071.22784810127,5003,4643
1600,"Clay, Sullivan, Parke, Fountain, Vermillion & Warren Counties",-363,18,21979.2,1813,1450
1100,Southwest Georgia Regional Commission,-363,13,26126.275862068967,1938,1575
1700,"Dallas, Bibb, Marengo, Hale, Sumter, Perry & Greene Counties",-371,1,22980.450980392157,1767,1396
1600,East Texas COG,-372,48,28675.425,4142,3770
2790,Southwest Heartland,-373,12,23062.285714285714,4153,3780
500,NA,-374,28,26381.999999999996,4059,3685
51040,New River Valley Planning District Commission,-375,51,35794.02173913044,3191,2816
400,Deschutes County,-376,41,24455,4180,3804
9100,Okaloosa County,-379,12,29789.8923076923,5570,5191
4000,Central Savannah River Area Regional Commission,-382,13,25555.285714285717,5456,5074
6300,Apalachee Region,-384,12,22124.285714285714,3144,2760
5500,Napa County,-386,6,32142.977272727272,2246,1860
400,"Lincoln, Warren, Audrain, Pike & Montgomery Counties",-390,29,21940.030303030308,3183,2793
1600,NA,-391,28,20249.043478260868,1988,1597
2400,Berrien County,-392,26,26444.540540540715,3589,3197
900,Florence & Darlington Counties,-393,45,18868.2857142857,4037,3644
900,Middlesex County,-393,34,32102.866666666683,8232,7839
3700,Kendall & Grundy Counties,-396,17,43026.30927835052,2853,2457
700,NA,-396,40,34090.88571428572,4512,4116
800,Hunterdon County,-397,34,41604,1364,967
400,NA,-397,8,32141.171974522287,2610,2213
200,Matanuska-Susitna & Kenai Peninsula Boroughs,-398,2,45184.454545454486,3428,3030
500,NA,-401,31,31657.387096774182,2525,2124
1700,Guilford County,-405,37,18367.78723404254,9923,9518
1500,Chatham & Lee Counties,-408,37,18241.26829268293,2123,1715
1700,Schenectady County,-409,36,18977.975609756097,2359,1950
2500,NA,-410,26,21949.444444444445,3155,2745
300,NA,-414,17,20647.28155339807,2074,1660
1500,Saginaw County,-415,26,22939.957446808512,3918,3503
2800,Livingston County,-417,26,35815.07407407408,2629,2212
6300,South Texas Development Council,-420,48,19670.052631578947,3731,3311
200,NA,-423,36,27127.94520547945,3488,3065
1000,Doña Ana County,-426,35,19415.014705882353,4196,3770
1800,"Chilton, Tallapoosa, Chambers & Coosa Counties",-427,1,23428.000000000007,2331,1904
100,NA,-427,37,15810.983050847468,1933,1506
1690,KIPDA Area Development District,-430,21,37700.98305084747,4000,3570
690,"Fremont, Chaffee, Park, Lake, Huerfano, Pueblo",-432,8,22169.1186440678,8687,8255
51010,LENOWISCO & Cumberland Plateau Planning District Commissions,-436,51,23501.096153846156,2789,2353
3900,NYC-Staten Island Community District 1,-439,36,33610.321428571406,3661,3222
2200,NA,-441,1,28977.069767441862,1618,1177
2400,Atlanta Regional Commission,-446,13,58222.8406374502,1799,1353
2200,Blair & Huntingdon Counties,-453,42,27367.41860465116,2805,2352
600,Monroe County,-455,42,31210.722222222223,2505,2050
1401,Fond du Lac & Calumet Counties,-464,55,41610.13846153846,2785,2321
500,NA,-464,54,19585.000000000004,1980,1516
2490,Salem & Cumberland,-469,34,27660.799999999996,3399,2930
400,NA,-477,2,32586,2591,2114
900,Cleveland County,-481,40,36853.87096774193,5761,5280
1200,"Raleigh, Mercer & Fayette Counties",-481,54,15681.325581395351,2892,2411
1400,East Central Kansas,-483,20,31733.855072463768,2543,2060
500,"Cole, Callaway, Moniteau & Osage Counties",-485,29,27330.863636363636,2980,2495
20000,Washington & Ozaukee Counties,-487,55,35758.54347826087,3685,3198
400,South Rhode Island,-490,44,32242.666666666668,1748,1258
200,Panhandle Regional Planning Commission,-494,48,29620.814371257486,4144,3650
2900,NA,-499,39,30746.190476190477,2232,1733
3000,Madison & Chester Counties,-513,47,29657.6511627907,1445,932
300,Southeast Oklahoma,-513,40,21286.923076923093,3576,3063
2100,NA,-514,36,10847.304347826077,1477,963
1300,NA,-555,39,29627.211538461535,1974,1419
900,"Jackson, Williamson, Franklin & Perry Counties",-569,17,25094.16666666666,3466,2897
2000,Albany County,-571,36,33310.433734939754,4984,4413
900,"Putnam, Boone & Lincoln Counties",-578,54,27517.625,1174,596
4700,Merced County,-583,6,22997.63076923077,5827,5244
500,"Walton, Washington, Holmes & Bay Counties",-583,12,22406.733333333334,7756,7173
1100,NA,-587,35,18048.034090909092,3400,2813
400,Passaic County,-592,34,30661.428571428583,5406,4814
1300,Essex County,-601,34,23853.575000000004,13322,12721
2100,Kalamazoo County,-602,26,23982.82456140348,5646,5044
1400,Hennepin County,-612,27,30077.07272727272,22840,22228
1001,NA,-613,55,24820,3637,3024
500,NA,-630,40,33440.41379310344,2398,1768
30000,Racine County,-642,55,25895.29411764706,3697,3055
6700,Cameron County,-647,48,14945.191176470604,6287,5640
3200,Memphis City,-656,47,19025.058823529416,24892,24236
1200,NA,-660,13,16159.050505050494,2826,2166
2000,Burlington County,-663,34,28669.729166666668,6273,5610
990,Central Region,-698,28,16926.666666666668,8140,7442
300,Frederick County,-714,24,36715.666666666664,3702,2988
3300,El Paso City,-735,48,24418.745762711864,16603,15868
3200,Philadelphia City,-761,42,19779.93220338983,22861,22100
200,Anderson County,-771,45,21572.782608695656,4031,3260
1000,Montgomery County,-779,24,30437.5,12145,11366
1000,Jackson County,-788,29,25792.830508474566,16492,15704
8100,San Mateo County,-835,6,31560.73228346457,7969,7134
3700,NYC-Bronx Community District 9,-843,36,23729.69696969699,21454,20611
3300,Boston City,-871,25,22306.244897959274,10592,9721
1300,Ramsey County,-887,27,23654.656488549615,11238,10351
2400,Regional Planning Commission 6,-909,22,15762.44000000004,7809,6900
3200,Nassau County,-959,36,31376.545454545467,9113,8154
1900,St. Louis City,-962,29,18158.857142857123,10360,9398
3500,Lancaster County,-972,42,28454.37500000001,9033,8061
300,"Greater Fairbanks, Greater Juneau, Ketchikan Gateway Borough & Road-Connected Alaska",-977,2,34039.269662921346,6298,5321
1700,El Dorado County,-1064,6,33463.39743589744,3782,2718
100,Providence City,-1109,44,20459.766666666663,11184,10075
6800,Hidalgo County,-1297,48,17019.338028169004,12269,10972
5900,Orange County,-1313,6,31634.697674418614,47052,45739
59300,Fairfax County,-1328,51,42759.75824175824,13869,12541
3200,Wayne County,-1333,26,21446.1612903226,38427,37094
7500,San Francisco County,-1374,6,21836.782608695652,8576,7202
100,Alameda County,-1498,6,36364.23140495867,20361,18863
8500,Santa Clara County,-1503,6,35205.126760563435,20366,18863
100,Coordinating & Development Corporation 1,-1525,22,23372.29850746269,5138,3613
3300,Suffolk County,-1654,36,39233.382978723384,10837,9183
100,District of Columbia,-2137,11,26248.499999999993,9143,7006
4100,NYC-Queens Community District 7,-2212,36,26480.171428571393,24394,22182
1090,Atlanta Regional Commission,-2456,13,21313.377777777772,37332,34876
100,Anchorage Municipality,-2706,2,32298.275862068964,11438,8732
8690,Miami-Dade County,-3199,12,19511.587412587487,46138,42939
7300,San Diego County,-3453,6,30360.719999999998,58495,55042
3400,Chicago City,-4094,17,24913.931297709925,88734,84640
4000,NYC-Brooklyn Community District 18,-4275,36,24984.000000000004,27738,23463
3800,NYC-Manhattan Community District 8,-4527,36,23630.9999999999,14500,9973
3700,Los Angeles County,-9673,6,25318.74999999996,150579,140906
0,NA,NA,0,37970,0,NA
1,NA,NA,150,44487.99999999996,4587,NA
1,NA,NA,200,13054.742857142926,13241,NA
1,NA,NA,213,10777.615384615387,802,NA
1,NA,NA,214,9723.307692307693,1315,NA
1,NA,NA,215,18954.500000000007,1176,NA
1,NA,NA,219,13677.478260869566,978,NA
1,NA,NA,250,7216.483870967727,2888,NA
1,NA,NA,261,2335.6712328767126,1124,NA
1,NA,NA,262,9321.461538461539,722,NA
1,NA,NA,263,15262.555555555555,1427,NA
1,NA,NA,290,20370.279411764706,1457,NA
1,NA,NA,315,25594.53846153847,1827,NA
1,NA,NA,325,7302.9999999999945,1169,NA
1,NA,NA,390,16625.500000000004,2803,NA
1,NA,NA,410,42231.07692307691,1715,NA
1,NA,NA,413,61627.37500000001,1981,NA
1,NA,NA,419,31175.526315789473,1275,NA
1,NA,NA,421,34500.799999999996,781,NA
1,NA,NA,429,32570.0202020202,2014,NA
1,NA,NA,435,24160.74193548387,2170,NA
1,NA,NA,438,23599.818181818184,1227,NA
1,NA,NA,453,31878.500000000004,6724,NA
1,NA,NA,459,31410.41666666668,2340,NA
1,NA,NA,465,42198.76388888889,396,NA
1,NA,NA,500,31302.851851851854,4788,NA
1,NA,NA,501,32236.89473684211,5423,NA
1,NA,NA,502,32607.862068965493,5912,NA
1,NA,NA,503,29773.35135135135,543,NA
1,NA,NA,515,26624,1889,NA
1,NA,NA,517,24800.333333333332,533,NA
1,NA,NA,518,19184.5,1428,NA
1,NA,NA,519,21640,2069,NA
1,NA,NA,520,10816.363636363647,1236,NA
1,NA,NA,521,31600.28205128202,3865,NA
1,NA,NA,523,24687.473684210527,1898,NA
1,NA,NA,525,21224.916666666657,683,NA
1,NA,NA,540,49502.51428571429,696,NA
1,NA,NA,542,16928.5,907,NA
1,NA,NA,543,35957.4054054054,7417,NA
1,NA,NA,551,32513.882352941197,3699,NA
1,NA,NA,599,14216.157894736865,1577,NA
1,NA,NA,611,6304.666666666684,578,NA
1,NA,NA,619,24045.000000000004,1108,NA
1,NA,NA,620,19012.991071428565,812,NA
1,NA,NA,621,9160.344827586207,2815,NA
1,NA,NA,699,18660.13253012048,2097,NA
1,NA,NA,701,47774.25806451613,1380,NA
1,NA,NA,900,33188.71604938272,1889,NA
2,NA,NA,110,13085.78070175439,7802,NA
